tn5_1	GCACAGTACAGAGCTG
tn5_2	GTGCACAGTTCTAGAGTGTGCAG
tn5_3	CCTCTACACTGTGCAGAA
tn5_4	GCACAGTTCTAGACTGTGCAG
tn5_5	CTGCACAGTGTAGAGTTGTGC
dnase_1	TTTACAAGTCCA
dnase_2	TGTACTTACGAA
NRF1	GCGCATGCGC
AP1	CGATATGACTCATCCC
CTCF	TTGGCCACTAGGGGGCGCTAT
ETS	CCGAAAGCGGAAGTGAGAC 
SP1	AAGGGGGCGGGGCCTAA
RUNX	CCCTAACCACAGCCC
NFKB	GCAAGGGAAATTCCCCAGG
GATA+TAL	GGCTGGGGGGGGCAGATAAGGCC
TAL	GGCTGGG
NFYB	CCAGCCAATCAGAGC
GABPA	GAAACCGGAAGTGGCC
BACH1+MAFK	AACTGCTGAGTCATCCCG
NRF1	CCCCGCGCATGCGCAGTGC
HNF4G	CCGTTGGACTTTGGACCCTG
